--------------------------------------XX-------------------------------------------o---------------------------------------------------------------------------------------o----------------------------
--------------?------XX--------------------------------X--XX-------M-o--X------XX----M-----------------------------E---------XX-E-XX-o---------------XX--------?-----X-------XX----o--M-----------------
---------------------E-----XX------------------o------------B---M-M-------------X-----MXX--?-------------XX---E---------------------E---o--------------------B--?----------B---X--M---XX----E-----------
-----------------E-----o-------EM--XX---X--------?----------E--------M-------------------X----------XX?----?-------------------XX---?------?----------XX----M---M----------------o-EB-?-------------M---
---------?---BXX----------B-----X-----E------o------BX--------XX---------------XX--M----Xo----------------o----XX--------------------M-----------oo------M-------------o---X--------------------B---E---
--------------M-------oXX-----------XX-------X---------------------XX-----B----------------?-X----X----------XX---------B---------------o--------oE-?----------------ME--------------o----X---XX--------
-------------E-----------M-B-------------------------o------------M---------E----E----------B----------------------------o----B---------E-----?--T--XX------M-XX-------XX-XX------------B---M--BXX------
----E-----XX---E-X---XX----B---o------------M--------M---B--------------------M-M-----------------------------------E-----E----?------------??---XX----------B-----B---------------o-----------M-------v
------------o---E-----------B-----?-----------E--------------------B---------------X-----------XX--------E----o-o-----XX-T-------------?------------E--------E-----X---X-----------M-------o---M---M---f
---?------XE----oE-------o--------B----------M-------B----------------XX----------X--------------------X-------o---------XXX--------------M-------XX-------------o-------------------------?-----------f
----------------M---------?--------?---?--XX---E------------o------------XX------------------------------------------------------o---------------?---E-------------------------XX--?--------------EXX--f
-----------------------o--------------XXE------XX--E-------oo--E----------------------------XX--------------------Xo---------------------------------------B----oo--o-------------XX---XX----------M---f
--------B--------------o-?--------XXXX------------BM-------T---X-----------------M------B-XXo---------o----XX--M-----------------XX-------------------------------E-------------XX--------M------------f
---X--------XX---------T-XX------------XX-o------------?--XX?-----------E---o--XX--------E-----------E-o-------------o--------M---X-X------------------E-XX------T-------XX-------X----------E-Eo------f
m-------------M--------|----M----------------------o-------------------------------------------------T---------------E--------------------------------------X-B--|----------?---------------T--T-------X
XXXXXXXXXXXXXXXXXXXXXXXXXXXXXXXXXXXXXXXXXXXXXXXXXXXXXXXXXXXXXXXXXXXXXXXXXXXXXXXXXXXXXXXXXXXXXXXXXXXXXXXXXXXXXXXXXXXXXXXXXXXXXXXXXXXXXXXXXXXXXXXXXXXXXXXXXXXXXXXXXXXXXXXXXXXXXXXXXXXXXXXXXXXXXXXXXXXXXXXX
