---------B------------oB----E--XX---------------------------------?--------------------------------XX-------B---o-----------------o-----------------------------B-----?--------------M----------M-------
---------------------?-?----B--?B-------B-----??-------X------------o--??X-------B--------------X---XX----------------E---M---------------o-------------------------M--?---M----X-o-----E?X-X----E-MXX--
XX-----------B--------X---Mo----B-------------o---------------X?-?----XX----XX---o--B-----------------------?---------------XX----------B-------o-----E--------------------B--------?----------B--------
---?---------------------?-o-------------?-B-----------XX---E------XX---------------------------X------B--X-------B-X---------?---M------o---------B-----?-----B---------------------E?---XX------B-XX--
----o-------------------------o-XX-----------------------------?--------o----o---------------------B---?--B---------XX-------------o----------------------B---?-----------------?XB------------M-?------
-XX---------MB---------------------------?---------------X-------------------o------------?----B---------------?XX-----------------X-----X--------M----X-----------------B---------?B-------o?---?---M--
-----------?--o-----------------------B?------------------X------B--------o---------XXM-------XX--B?---o---o-------------XX--------E--------------E-----B--------------o---B-----------o-----XX---------
--------------XX----------------------X------------XX--?----XX-------------o-------------------------X-XX--------------------------------------------------------------------------oM------B-----oo----v
----XX--o----o----------?---------M------XX----------o-----------XX--------XX------------------?---------------------X-----E-----------X-o----XX------o--------XX------B-----?XE--o-------B---o-B----o-f
---------------?---o----?----?-o---B--------XX-----------B-----B------------------------------------------o-----XX--------o--------------X----------?-EE----------BB----------E--XX-?----B-----XX--X---f
--?---B--oBo---------XBB------XX----------XX----------XX-------?-------M--M--XX-----------XX-?B------X-------?-------XX----o-------XX----------------?T----o------------B------------B-----?-----------f
----B---------XX----E-M----------------XX----E-----------------------------E----------B----ooo------B------------B----|--o--B----?-------E---XX---M---|----XX--o------------------o--XXM-?-oXX------XX-f
------XX------------?-------------o--XX----------o----------------?---o---o-----B------------Eo------B---------o---M--XX-EE-----Xo-------------------XXX-----B----------XX-XX--------------------?o----f
-------E----?--------------------o-X-----------------------------o--XX-----BXX-------------T-T-------?------------------BT--------o--------------------------------------?-------X----XX--T-------E-XE-f
m-----------------------------------------------------------------?----X------------XB-----|-|--B-----------------o------|-------T--------------B-------------Bo-------------------E------|----------T-X
XXXXXXXXXXXXXXXXXXXXXXXXXXXXXXXXXXXXXXXXXXXXXXXXXXXXXXXXXXXXXXXXXXXXXXXXXXXXXXXXXXXXXXXXXXXXXXXXXXXXXXXXXXXXXXXXXXXXXXXXXXXXXXXXXXXXXXXXXXXXXXXXXXXXXXXXXXXXXXXXXXXXXXXXXXXXXXXXXXXXXXXXXXXXXXXXXXXXXXXX
