--B|oMXB-T---T-----------------X----?X-ME----BTo-TT|B-|M|--B-M??--E---M-----To-|--XT--------B|-XMo----o-o|-------XoX-X-E-?|--BT----X-X-B-------E-----o--XX------MB-M--B-|?------?-T--EBE-o-|-M--E--E---E
M|-----|-----|o---?o-T---E--oB-E--?---oM------E||-BM--o?|T-M?X|-E-Bo?--To----M-ME--|--T-EM-o-|B-|---E--|---oBo|M----X?T-o?--B--T------o--||--?----o-------MoB-----o|?-----------T--?-?M?-o-----|--o-T-T-
M-X--o-T?TB--E------X|----XoE-E|--EoT--M-B|--?B-E?---X--T------X?MX---------oM-TT-B-oT---M-----MX------o|--|M--M-oB-T----?---|E---?---T---E--------EXTo-X--M-XB---X------M-E-Eo-T----|-M------EMEM?---E-
?--oB-X-BMX-B---?|BEE-----E---o-?-oEM-o-------|TT-|---|---?T-?--T---M-?|-----T?T-o-|----?|--E-?-E--B?XT--------EB-E---T--|?-------M--X----oXE------T--oE--E--E----M?--EX----M--------?BEEo|E---X??-M--MM
?M---BBT---Mo----B-o-|--X-B?-oT-?-M-BBT-?BT---X-M-BMXXB--Bo-EE-E---?-----EXTMB--T|----M-E-o?o----BXT--M-B?-Eo--|--?|?|-T-EM-E-B----|?-------??--M-----M-B-BEB------B-X---o|MX-B--X-?--?-|--T--o----??--M
B-----B--MT--E-B?-----MEM--ET-X--B-|------|----|-o----|X-?---B-X-o-M-----T--EEM-||--o-T------o-T-||ET----B-o-B-M----T----?-Eo|----T-o|--o-M--M-E------E--?|X-----T---MX--X-??--X----M-E?---M-TBM|o-BT--|
M-TT-?----?------------X-?B----M-E----B|--------B|o------X?--|----|T-----XX-----BM--?o-?--M-ME-E-X--|---B-XX-|o-M--E-T---T--?--?-----oEB---M----?-EBT-ME----o??--M-E--M-X--XE----------B-B--XB--o-X---XT
--o------T?-M?--E--MT??-X-?--T--MB-X-------EEX---ET-?X------E---X-------XT-TE--?--|X----T-Eo--------E-BT-E-|-----X------o-oE-------X-|-?-|M----o|-E---XB-------B-----M-----M-TTB--|oM-?----oT----oEo-ovB
o---o-|--?--|-M---X-XE?B----|oB-----E----o--?----TE---B--M-|T---E?T|---------X---T-X-??--B-X---X?-----o-oX-B--|BT-oE----------X---X-oM--MB-?Bo|----------ToTE---X----|E-|---T-T-E-----E-?-M--E----M---fM
--E----M--|--B-|--------BoEM-B---T|E?T-?--B-oT--B-BB--T--?--X|--B---Xo--?--|-T---?--o--E-T|?o--?--X?M-?-?-X----?o|T----B--B-E--?--?o---?EBM--o-----------X||X---T-----??----MEB-|-EM----X-----E-o-TX-Xf?
T----|---XM----------oE-XB-EoEM-E---------?-------?MT-|-X-------X-?-E-----EM----|-E--?M--BMT--?----T---EXE--?--E-T----E-?--o-o-T----T---M--TM-----T--oB|oX----o-B--E|-T-B|-|-|--T---X---X--|------|ETBfo
TEE-X------|-------o-|E--|---X-oE--XoM|--T-B-----TEoT--X-?---|------XT?X------BE-XM-|--E--|--T--oM---oM-----BBE---?------B-|-?----B--E--XM------X?-T----M----BX?E--M--M--X|?---?--|--|----|X----------fM
|B----B--oT--oMoMT--EB-TT-M-MX----?B-----E-o?------?----E-B-X----M--T---M---------E---To---|-----EME---B--|--|---M-B|-E-|B---------oT---|Bo--E--Bo---B--oT--?--TB------o-XT---TM-------B---MT--?-o?T-Xfo
TTX-B|--T--E--E--E-?--TMT----X---|||-o--|o---|M------?E--E---------M-M--X-|---E-T-?|-|------|--BT|-o-EXT--T--------BMo-----B-B---E--o-E--B--|B----TE-T-?----TT|---M--E--T----|-??-----o---|-XB-?------fM
m-B--|o-----|-----XBE---Bo-B----o-|-ooo--BB-TBE--E---?X--T-B|---XB-X-oB-X-B-E-X--E--XX-T-T-M-?E-|---X-?---X----T--M---TE--?---MX---BE---TXo?-----B--?--BoEE--TB--EEBBoB---|--T--?EMM--M---?-------X---Xo
XXXXXXXXXXXXXXXXXXXXXXXXXXXXXXXXXXXXXXXXXXXXXXXXXXXXXXXXXXXXXXXXXXXXXXXXXXXXXXXXXXXXXXXXXXXXXXXXXXXXXXXXXXXXXXXXXXXXXXXXXXXXXXXXXXXXXXXXXXXXXXXXXXXXXXXXXXXXXXXXXXXXXXXXXXXXXXXXXXXXXXXXXXXXXXXXXXXXXXXX
