|-X---E-o?--?----M----E--B-E-----------------M--E-----B----?---B---o-M--M?--------X-----------E-MXEE-E---B-o------M-B--EB-------?----?-X-Xo--?------E----BB----B---B-X-X-------------?------M----Eo-X-?T
|-T-------B-o-BE--E--E--------------o----o-----E-?XM----B-----B-o---E----?-M-o-?------XX-----?-?E-X-E---o---o---X-------B------M--o--E-oBM---XME----?----M?-----B-?--M-B-------Bo----------X---X-o--T-MB
|-|-----M-B---XM--M-Bo-X-M?-E---B--------B-----E--------B----------EE----------BB--M----ooB-X--?--------E----M----X---E----oX-E--EX-M-------X-E--E--B?-M---------B--------B---M------B-o----oo-----X|-EE
|-XB-E--B-------M-M?--E--XEB-?----M------oB--B-MM-----B?--?------E-------X------E--B--X---------oE--??--------------E---o--X-E--?---o----EB----M-----o--E---?-B--?---X-o-o-----------E------E---o---XXMT
|--B--M--X--o--MB?-?--------EM?--E---?-----E-----?M---o-----B--M-B--X-???-----E------o-------?----------M---------BE-----B---Eo--B----??---o-M------BX----X--o-o------M------o------B------------E-----M
|-B--X--?-E-X?----E?-XE---X-ME-----------X---B---o--E-?--?E---X-----M--o-BX--MM-------o----X------o---E-------B----------X-B-------E--??-o--B?------Bo---------B--B------M--X----B--o---------?--?-EM-BM
|--E---M----?--X----M-E---X--ME--X-o---B------M---M-X--BX?E---B-M-?-M--------EM---X--BX-----E-X--B---o---M-----------M-E--?---E-oo-o-o-E--B-----oBo-------oM-?-------B--X------------?-----?-----X-B--o-
|-X?---o-X--M-?---------------Xo---------X-E-----X-X--o-M-----M----?-M----M-BX------oMo--o-B---E-?--B----?-Moo-M-------X---B--o--B----o--XX-X----B--X-E-?EM---------o-X-oM--B----?----------------EE-?Xv
|-|-M?-----oE-?-----?---oo-MB----------------oBE-M-X---------?M--------X---X?--M--E-E----oX-?-B---o--M-------B--M------B-B-M---M----XoX---X--X---B--B--------B--------M----XoB------B----------M---ME?of
XXX-----------------M-BE---M---ME-B------X---oEE-M--?X?-----------X----Mo-X---?-M---?E---o?B-B-X----------o-----o------o--------o?---?--E-X-o---?------o--BE-Mo------E--E-----B-X------------X-------|-f
?T--------------BE-?-Bo----X---EXMX-?---------o--------------BE--Xo------------Bo-BXo----?------B--E-B-M---M-E--B----B---Bo---?--o-E-------------o----?----o----?MoX--ME--------B-E-o-B-M---------EB-XXf
-|-B--E--oX----o------Xo---------oXM----------E--?----EE-MX-X---MB-X-M---B------oX----------------X------o-o-------MB--B---Xo?-----?--Bo-E------o---?-----o-E--------B--------EB------o----oEX-B-B-o-EXf
E|-E--?----------??--?--X----------Eo---B----?-Eo-----------?---?X----o-X-o-----EM--o-X-B---X-XXEo--------------XM---X-X-----B----------o--MX--EMM--?X--o---o--o-----------------o-----BB----o----XM??Mf
XXX--X-X---?--?-B----?X-----E-------B--M---X---???----ooM--B--oM--B--------?-----BE------------?X-----M--------B-------?--?---X------B------o-E-X------E----M-----MXoE--------M----?---M--E-o-oo-X-EX-Ef
m--o--o-o--M---X----B--X-BE----------?--Bo--------?-o-------M--XX----B--X--B----X---B---B-MB-----E--------XBM-XM-------XX-B-?------X-----M---XM--X--------------B--oo-X---B-EE------E------o---o-?--TE-X
XXXXXXXXXXXXXXXXXXXXXXXXXXXXXXXXXXXXXXXXXXXXXXXXXXXXXXXXXXXXXXXXXXXXXXXXXXXXXXXXXXXXXXXXXXXXXXXXXXXXXXXXXXXXXXXXXXXXXXXXXXXXXXXXXXXXXXXXXXXXXXXXXXXXXXXXXXXXXXXXXXXXXXXXXXXXXXXXXXXXXXXXXXXXXXXXXXXXXXXX
