----MXT---o|XX|--E-?MEE--M|--|-Eo---|-B-B|-----oX---M--M-MMT?T----T?|------X-EoT-----|-XM--------E---||----EMB---|--B-?---MXX-o?--?----?--T---MM--EE-Bo----E-TM---To--T-X-E-MB--M-M---TTMME-B--T---oMM?-
-EEo|----M-|B-X-|?-TX-X|--o-BX---T?-T-M--E---X-M-|-?-E-XM--XE-|--o-E|-EEM---o-oXXM--MBTo--|TTX---E-----E--X---M|?B---o?XME---BT------|X-XB--oM---M?X--o---o--TXX-EM--o?X----BE-E---X--BT-E--X?--M--|--T-
-o-TT??MM-B|?----?-BB?M-?|TTTM-ET----X---??MM--BX---MT---o--BT---o----?------X-?BM----XX--B---TX-BXTM--oB--?--o?o---|---M--o--|-B?---TB-M-?|TE---TMX-?-T---B--E-T-----o-E-TMo?EM-E--oM-T|-o-ET-EXo|E----
-B-B--To--BM--X-?-?||o---B-B---EB---E-|-o-T---B-M--o-X---o---B|o-T-MXX----E-----E--T----T-X-oM?--o----X-To|-EB-EMXT|-?--?-X--TB--E|-oM-o-------T-?BM-o-MT----X--|MX-B--B---M-o?oM--?-??-E-Eo--B-B|E--?M-
-Mo-EM----B-----------|-|-----?---X?--o---T---B-?---?EE-ToE---M-BE-------|BXMMX-|E-EXE--?-----EX-EM?--|?Xo--E-X?-|MM---To--|-X--X-|----M--B---T---T-----?|----EXX-o---M-E-M-Bo-B-oE--o|----M-ooo?-?-----
-XXM-T-o-MX-X--M-X--X--M-|o---X|----TB|-MM|---To--E-BB-Xo-o--?-E-X--------|T---oE-B-E--M|B-BEo-TTX-|-MT--o-Xo--E-----?----ETM----MB---X----MMB---XEX-X--o--X-E???T--T---M-M---B--T--T---M--|oT?---X-|---
----E-|---------E------o--E-M---E--B-X---||XM-XoM-XBX---M---|oT--X----X----E--|-T-E-MoE--B-M---E-?--E--M--XX--|------T?--?-o--BE-To---EM--M--?--M?-MoTM-T-|--M--E--oXT-oBE--o--M-E---T---Mo----M?-----T-
-B--?-X-XB--Bo-Mo|--X----B-|-|--?----B-EM-B----M-o-----|-E-B-X----T--oB---?--BBoo-B-?|-B?-?--?--T-TM-oBM-------BMo---M-M|X-----E---?--X-Xo---|-----E|-M-?|----?--B-M??E-|---M-?BE|??-EX-XE|---T-E?---Tv-
------T-E--M-T-o|o-X--|---T-M--TBB|---|BXE-T||?-E-E-EMM-E-o-E-|-?-|-B?--BX----B-?----|B----T---------E--|E-T-E||X---?M?---?---XT-EMXB|T|-B----BM---------T-B-XT-M-M----|X-TT-oMB--?-X-oT-EB-E-oMoEM---f-
--o-X-|-|--?--|--BE-----BM-M?--E-E?o---M-BE|--E-o|--E--|--o?--B?--?X--X-?o---T-?|M?BE-M|---o----X-MM-------BoE|---------?---oEo----B--Moo?-X----M--Mo--X---|--?--B-B----?M-?-T|---E-----M---B-o-TM|--Bf-
--B--X?---XT--M-XE---M--||-|--B---?---ETB--T-|-BMo-B-E?E-B---BE-?--??---oTEE-----B|Eo-o---XT-----o-B-----T-?-|E-M-E-|BB-BBB--X------------BE-MXB--X-o-To?o----M----|--BE--E-?--M-T-?Eo-M-oTX-XX?--X?o-f-
-T|----T-?BE|---EM----MoE-------o|-XTMB-|----X-|TX--?E-T--EM-?----T----|--B----|?-XE--XB--?MMEX-|ME|X-|B-MB--?----|--T-TT----oBX-X-X|-oE--M------|--?-E-M--E?-----XoM-B-EEE-?T---EEMX--M-B-X|-Xo-||--Mf-
--Xo---X|X-E-M--?-?--E-B---|---o--|-oEo?o--?-M-|-oT------M?T------o----X---TM|----X--X?X-E-TB-M--|M----TBT|TE--Bo---T-TM----T-?XBE-T-|-----M-X--|T---BM----|-XM|--T-EMMBo-M?--BXoME-o---BETEX-TT--o-XBf-
-------ET-M-----|B-X-?B-X--E-?|--T-MT--|B?-BE-?ME-EE|-B?-|-T-X--MoT?T--------B--E--o---T-o---o|-B-B-------?EXB--TM-B-EM--BM-----T-X-----T|T------|----M?E---BX-X-oB-B-?-B--oM-oB-E-?Bo--E-|----TBo-ME-f-
mMo-BE---T?M?---|--o-E-BT-EM|--E-o--MM-X-?-M-oX--BM-X-M-T---o-o-o---o--?---o-----X--Eo---T---?--ET---EoBTT------E?-X|TB-----T|-T-T-E-MMM|-oE-XE-M--EXo---T--MT-T----------T|-E|-M--E-?-T---Eo--T----M-X-
XXXXXXXXXXXXXXXXXXXXXXXXXXXXXXXXXXXXXXXXXXXXXXXXXXXXXXXXXXXXXXXXXXXXXXXXXXXXXXXXXXXXXXXXXXXXXXXXXXXXXXXXXXXXXXXXXXXXXXXXXXXXXXXXXXXXXXXXXXXXXXXXXXXXXXXXXXXXXXXXXXXXXXXXXXXXXXXXXXXXXXXXXXXXXXXXXXXXXXXX
